2,2,2,2,2,2,2,2,2,2,2,2,2,2,2,2,2,2,2,2,2,2,2,2,2,2,2,2,2,2,2,2,2,2,2,2,2,2,2,2,2,2,2,2,2,2,2,2,2,2,
2,2,2,2,2,2,2,1,1,1,1,1,1,1,1,1,1,1,5,5,5,5,5,5,5,5,5,5,5,1,1,1,1,1,1,1,1,1,1,1,1,1,1,1,1,1,1,1,2,2,
2,2,2,2,2,2,2,1,1,1,1,1,1,1,1,1,1,1,5,5,5,5,5,5,5,5,5,5,5,1,1,1,1,1,1,1,1,1,1,1,1,1,1,1,1,1,1,1,2,2,
2,2,2,2,2,2,2,1,1,1,1,1,1,1,1,1,1,1,5,5,5,5,5,5,5,5,5,5,5,1,1,1,1,1,1,1,1,1,1,1,1,1,7,7,1,1,1,1,2,2,
2,2,2,1,1,1,1,1,1,1,1,1,1,1,1,1,1,1,5,5,5,5,5,5,5,5,5,5,5,1,1,2,2,2,2,2,2,2,2,2,1,1,7,7,1,2,2,2,2,2,
2,2,2,1,1,1,1,1,1,1,1,1,1,1,1,1,1,1,2,2,2,2,2,2,2,2,2,2,2,1,1,2,2,2,2,2,2,2,2,2,1,1,7,7,1,2,2,2,2,2,
2,2,2,7,7,7,1,1,1,1,1,1,1,1,1,1,1,1,1,1,1,1,1,1,1,1,1,1,1,1,1,2,2,2,3,3,6,6,6,6,6,6,6,6,6,6,6,3,3,2,
2,2,2,7,7,7,1,1,1,1,1,2,2,2,2,1,1,1,1,1,1,1,1,1,1,1,1,1,1,1,1,2,2,2,3,2,6,6,6,6,6,6,6,6,6,6,6,2,3,2,
2,2,2,6,6,6,6,6,6,6,6,6,6,6,2,1,1,1,1,1,7,7,1,1,1,1,1,1,2,2,3,2,2,2,3,2,6,6,7,6,6,6,6,6,6,6,6,2,3,2,
2,2,2,6,6,6,6,6,6,6,6,7,7,6,2,3,2,2,2,2,7,7,1,1,1,1,2,2,2,2,3,2,2,2,3,2,6,6,7,7,6,6,6,6,6,7,7,2,3,2,
2,2,2,7,7,6,6,6,6,6,6,7,7,6,2,3,2,2,2,2,7,7,1,1,1,1,2,2,2,2,3,3,3,3,3,2,6,6,7,7,7,6,6,6,6,7,7,2,3,2,
2,2,2,7,7,6,6,6,6,6,6,6,6,6,2,3,2,2,2,2,1,1,1,1,1,1,2,2,2,2,2,2,2,2,3,2,6,6,6,7,7,6,6,6,6,6,6,1,1,2,
2,2,2,7,7,6,6,6,6,6,6,6,6,6,2,3,2,2,2,2,1,1,1,7,7,7,2,2,2,2,2,2,2,2,3,2,6,6,6,6,7,6,6,6,6,6,6,1,1,2,
2,3,3,6,6,6,6,6,6,6,6,6,6,6,3,3,2,2,2,2,1,1,1,1,1,1,2,2,2,2,2,2,2,2,3,2,6,6,6,6,6,6,6,6,6,6,6,2,2,2,
2,3,2,6,6,7,7,7,6,6,6,6,6,6,2,3,2,2,2,2,1,1,1,1,1,1,2,2,2,2,2,2,2,2,3,2,6,6,6,6,6,6,6,6,6,7,7,2,2,2,
2,3,2,6,6,7,7,7,6,6,7,7,6,6,2,3,2,2,2,2,7,7,7,1,1,1,2,2,2,2,2,2,2,2,3,2,6,6,6,6,6,6,6,6,6,7,7,2,2,2,
2,3,2,6,6,6,6,6,6,6,7,7,6,6,2,3,2,2,2,2,7,7,7,1,1,1,2,2,2,2,2,2,2,2,3,2,7,7,7,7,6,6,6,6,6,6,6,2,2,2,
2,3,2,6,6,6,6,6,6,6,6,6,6,6,2,3,3,3,3,3,1,1,1,1,1,1,2,2,2,2,2,2,2,1,1,1,7,7,7,7,1,1,1,1,1,2,2,2,2,2,
2,3,2,6,6,6,6,6,6,6,6,6,6,6,2,3,2,2,2,2,1,1,1,1,1,1,2,2,2,2,2,2,2,1,1,1,1,1,1,1,1,1,1,1,1,2,2,2,2,2,
2,3,2,2,2,2,2,1,1,1,2,2,2,2,2,3,2,2,2,2,1,1,1,1,1,1,2,2,2,2,2,2,2,1,1,1,1,1,1,1,1,1,1,1,1,1,1,1,1,2,
2,3,3,3,1,1,1,1,1,1,1,1,3,3,3,3,3,3,2,2,2,1,1,1,1,1,2,2,2,2,2,2,2,2,2,2,2,1,1,1,1,1,1,1,1,1,1,1,1,2,
2,2,2,2,2,1,1,1,1,1,1,1,2,2,2,2,2,3,2,2,2,1,1,1,1,1,1,2,2,2,2,2,2,2,2,2,2,1,1,1,1,7,7,7,7,7,1,1,1,2,
2,2,2,2,2,1,1,1,1,1,1,1,2,2,2,2,2,3,2,2,2,1,1,1,1,1,1,2,2,2,2,2,2,2,2,2,2,1,1,1,1,7,7,7,7,7,1,1,1,2,
2,2,2,2,2,1,1,1,1,1,1,1,2,2,2,2,2,3,2,2,2,1,1,1,1,1,1,2,2,2,1,1,1,1,1,1,2,1,1,1,1,1,1,1,1,1,1,1,2,2,
2,2,2,2,2,1,1,1,1,1,1,1,1,1,1,2,2,3,2,2,2,1,1,1,7,7,7,2,2,2,1,1,1,1,1,1,2,1,1,1,1,1,1,1,1,1,1,1,2,2,
2,1,1,1,1,1,7,7,1,1,1,1,1,1,1,2,2,3,2,2,2,1,1,1,7,7,7,1,1,1,1,1,1,1,1,1,2,1,1,1,1,1,1,1,1,1,1,1,2,2,
2,1,1,1,1,1,7,7,1,1,1,1,1,1,1,2,2,1,2,2,2,1,1,1,1,1,1,1,1,1,1,1,7,7,1,1,2,1,1,1,1,1,1,1,1,1,1,1,2,2,
2,1,1,1,1,1,7,7,1,1,1,1,1,1,1,1,1,1,1,1,1,1,1,1,1,1,1,1,1,1,1,1,7,7,1,1,2,1,1,1,1,7,7,1,1,1,2,2,2,2,
2,1,1,1,1,1,7,7,1,1,1,1,1,1,1,1,1,1,1,1,1,1,1,1,1,1,1,1,1,1,1,1,1,1,1,1,1,1,1,1,1,7,7,1,1,1,2,2,2,2,
2,1,1,1,1,1,7,7,1,1,1,1,7,7,1,1,1,1,2,2,2,2,2,2,2,2,2,2,2,1,1,1,1,1,1,1,1,1,1,1,1,7,7,1,2,2,2,2,2,2,
2,1,1,1,1,1,1,1,1,1,1,1,7,7,1,1,1,1,4,4,4,4,4,4,4,4,4,4,4,1,1,1,1,1,1,1,1,1,1,1,1,1,1,1,2,2,2,2,2,2,
2,1,1,1,1,1,1,1,1,1,1,1,1,1,1,1,1,1,4,4,4,4,4,4,4,4,4,4,4,1,1,1,1,1,1,1,1,1,1,1,1,2,2,2,2,2,2,2,2,2,
2,2,2,2,1,1,1,1,1,1,1,1,1,1,1,1,1,1,4,4,4,4,4,4,4,4,4,4,4,1,1,1,1,1,1,1,1,1,1,1,1,2,2,2,2,2,2,2,2,2,
2,2,2,2,1,1,1,1,1,1,1,1,1,1,1,1,1,1,4,4,4,4,4,4,4,4,4,4,4,1,1,1,1,1,1,1,1,2,2,2,2,2,2,2,2,2,2,2,2,2,
2,2,2,2,2,2,2,2,2,2,2,2,2,2,2,2,2,2,2,2,2,2,2,2,2,2,2,2,2,2,2,2,2,2,2,2,2,2,2,2,2,2,2,2,2,2,2,2,2,2